21000000000000000000
01101111000000111000
00111001111111101100
00000000000000000100
00000000000000011100
00000000000000010000
01111111111111110000
00000000000000010000
00000000000011110000
00000011111110100000
00000010000000100000
00011110000000111100
00010000000000000100
00010000000000001100
00110000000000001000
00010000000000001110
00000000000000000010
00000000000000000011
00000000000000000001
00000000000000000003